1111111111111111111111111111111111
1000100000000000000000C00000000011
10E0110100100000101001100000010101
1110110010101010001001000000010101
1P00000000000000000000000000000011
1111111111111111111111111111111111
