1111111111111111111111111111111111
1E00000000000000000000C00000000011
10110101001000001010011000000101C1
1110010010101010001001000000010101
1P00000000000000000000000000000011
1111111111111111111111111111111111
