1111111111111111111111111111111111
1E00000000000000000000C00000000011
1011010100100000101001100000010101
1110010010101010001001000000010101
1P00000000000000000000000000000011
1111111111111111111111111111111111
