1111110111111
1E000000000E1
11110111111111111
1P10000000001
111111111111j
