1111111111111111111111111111111111111
10000000C10000010000000000000000C10P1
1011111111011101011101111011110111011
10000000010001010001010C1010000001001
1111110101010101010101011010100100001
1000000100010100010101000011110111101
110111011101011111011101111C10010C101
1E01C00100010000000000000100000100001
1111111111111111111111111111111111111
